"a" = (/obj/effect/turf_decal/siding/wood/corner{dir = 1},/obj/effect/turf_decal/siding/wood/corner{dir = 4},/obj/effect/turf_decal/tile/neutral{dir = 8},/obj/effect/turf_decal/tile/neutral,/turf/open/floor/iron/dark,/area/tdome/arena{name = "Talent Show Theatre"})
"d" = (/obj/effect/turf_decal/tile/neutral{dir = 8},/obj/effect/turf_decal/tile/neutral,/obj/effect/turf_decal/tile/neutral{dir = 1},/obj/effect/turf_decal/tile/neutral{dir = 4},/obj/structure/railing,/obj/effect/turf_decal/siding/thinplating/dark,/obj/effect/oneway,/turf/open/floor/iron/dark,/area/tdome/arena{name = "Talent Show Theatre"})
"e" = (/obj/item/pipe{dir = 5},/turf/open/floor/wood/large,/area/tdome/arena_source)
"i" = (/obj/structure/table/wood,/obj/item/stock_parts/cell/infinite,/obj/item/stock_parts/cell/infinite,/obj/item/stock_parts/cell/infinite,/obj/item/stock_parts/cell/infinite,/obj/item/stock_parts/cell/infinite,/obj/item/stock_parts/cell/infinite,/obj/item/stock_parts/cell/infinite,/obj/item/stock_parts/cell/infinite,/obj/item/stock_parts/cell/infinite,/obj/item/stock_parts/cell/infinite,/obj/item/stock_parts/cell/infinite,/obj/item/stock_parts/cell/infinite,/obj/item/stock_parts/cell/infinite,/obj/item/stock_parts/cell/infinite,/obj/item/stock_parts/cell/infinite,/turf/open/floor/wood/large,/area/tdome/arena_source)
"j" = (/obj/machinery/atmospherics/components/unary/portables_connector{dir = 8},/obj/machinery/portable_atmospherics/canister/toxins,/turf/open/floor/wood/large,/area/tdome/arena_source)
"l" = (/obj/effect/turf_decal/siding/wood{dir = 1},/obj/effect/oneway{dir = 1},/turf/open/floor/iron/dark/smooth_large,/area/tdome/arena{name = "Talent Show Theatre"})
"n" = (/obj/effect/turf_decal/tile/neutral{dir = 8},/obj/effect/turf_decal/tile/neutral,/obj/effect/turf_decal/tile/neutral{dir = 1},/obj/effect/turf_decal/tile/neutral{dir = 4},/turf/open/floor/iron/dark,/area/tdome/arena{name = "Talent Show Theatre"})
"o" = (/obj/machinery/door/window{dir = 8},/turf/open/floor/wood/large,/area/tdome/arena_source)
"q" = (/obj/structure/window/reinforced/fulltile/indestructable,/obj/structure/grille,/turf/open/floor/wood/large,/area/tdome/arena_source)
"r" = (/obj/structure/holosign/barrier/atmos,/turf/open/floor/wood/large,/area/tdome/arena_source)
"s" = (/turf/open/floor/wood/large,/area/tdome/arena_source)
"w" = (/obj/machinery/door/window{dir = 1},/turf/open/floor/wood/large,/area/tdome/arena_source)
"x" = (/obj/machinery/module_duplicator,/turf/open/floor/wood/large,/area/tdome/arena_source)
"y" = (/obj/machinery/component_printer,/turf/open/floor/wood/large,/area/tdome/arena_source)
"C" = (/obj/structure/window/reinforced/fulltile/indestructable,/obj/structure/grille,/obj/structure/grille,/turf/open/floor/wood/large,/area/tdome/arena_source)
"D" = (/obj/effect/turf_decal/siding/wood{dir = 9},/obj/effect/oneway{dir = 1},/obj/effect/oneway{dir = 8},/turf/open/floor/iron/dark/smooth_large,/area/tdome/arena{name = "Talent Show Theatre"})
"F" = (/obj/structure/window/reinforced/spawner{dir = 4},/turf/open/floor/wood/large,/area/tdome/arena_source)
"G" = (/obj/machinery/atmospherics/components/binary/valve/digital{dir = 8},/turf/open/floor/wood/large,/area/tdome/arena_source)
"J" = (/obj/effect/turf_decal/siding/wood{dir = 5},/obj/effect/oneway{dir = 1},/obj/effect/oneway{dir = 4},/turf/open/floor/iron/dark/smooth_large,/area/tdome/arena{name = "Talent Show Theatre"})
"K" = (/obj/effect/turf_decal/tile/neutral{dir = 8},/obj/effect/turf_decal/tile/neutral,/obj/effect/turf_decal/tile/neutral{dir = 1},/obj/effect/turf_decal/tile/neutral{dir = 4},/obj/structure/railing/corner,/obj/effect/turf_decal/siding/thinplating/dark/corner,/turf/open/floor/iron/dark,/area/tdome/arena{name = "Talent Show Theatre"})
"N" = (/obj/effect/turf_decal/tile/neutral{dir = 8},/obj/effect/turf_decal/tile/neutral,/obj/effect/turf_decal/tile/neutral{dir = 1},/obj/effect/turf_decal/tile/neutral{dir = 4},/obj/structure/railing{dir = 4},/obj/effect/turf_decal/siding/thinplating/dark{dir = 4},/obj/effect/oneway{dir = 4},/turf/open/floor/iron/dark,/area/tdome/arena{name = "Talent Show Theatre"})
"Q" = (/obj/structure/window/reinforced/spawner,/turf/open/floor/wood/large,/area/tdome/arena_source)
"R" = (/obj/structure/window/reinforced/spawner,/obj/machinery/atmospherics/components/unary/outlet_injector,/turf/open/floor/wood/large,/area/tdome/arena_source)
"S" = (/obj/effect/turf_decal/tile/neutral{dir = 8},/obj/effect/turf_decal/tile/neutral,/obj/effect/turf_decal/tile/neutral{dir = 1},/obj/effect/turf_decal/tile/neutral{dir = 4},/obj/structure/railing/corner{dir = 8},/obj/effect/turf_decal/siding/thinplating/dark/corner{dir = 8},/turf/open/floor/iron/dark,/area/tdome/arena{name = "Talent Show Theatre"})
"U" = (/obj/effect/turf_decal/tile/neutral{dir = 8},/obj/effect/turf_decal/tile/neutral,/obj/effect/turf_decal/tile/neutral{dir = 1},/obj/effect/turf_decal/tile/neutral{dir = 4},/obj/structure/railing{dir = 8},/obj/effect/turf_decal/siding/thinplating/dark{dir = 8},/obj/effect/oneway{dir = 8},/turf/open/floor/iron/dark,/area/tdome/arena{name = "Talent Show Theatre"})
"V" = (/obj/structure/table/wood,/obj/item/toy/crayon/spraycan,/obj/item/toy/crayon/spraycan,/obj/item/toy/crayon/spraycan,/obj/item/toy/crayon/spraycan,/obj/item/toy/crayon/spraycan,/obj/item/toy/crayon/spraycan,/obj/item/toy/crayon/spraycan,/obj/item/toy/crayon/spraycan,/obj/item/toy/crayon/spraycan,/turf/open/floor/wood/large,/area/tdome/arena_source)
"Z" = (/obj/machinery/light/floor,/turf/open/floor/wood/large,/area/tdome/arena_source)

(1,1,1) = {"
qqqqqqqwqqqqqqq
qssssssssssssiq
osxysssssssssVq
qqqqCsssssqqqqq
aaaaqssRrQqaaaa
ddSnqsFeGjqnKdd
lJUnZqqqqqZnNDl
"}
