"a" = (/obj/effect/turf_decal/siding/wood{dir = 1},/obj/effect/oneway{dir = 1},/turf/open/floor/iron/dark/smooth_large,/area/tdome/arena{name = "Talent Show Theatre"})
"b" = (/obj/structure/alien/weeds,/obj/structure/alien/weeds/node,/turf/open/floor/mineral/titanium/tiled,/area/tdome/arena)
"c" = (/obj/structure/alien/weeds,/obj/structure/bed/dogbed,/turf/open/floor/mineral/titanium/tiled,/area/tdome/arena)
"d" = (/obj/structure/alien/weeds,/turf/open/floor/mineral/titanium/tiled,/area/tdome/arena)
"e" = (/obj/structure/alien/weeds,/obj/structure/bed/nest,/turf/open/floor/mineral/titanium/tiled,/area/tdome/arena)
"f" = (/obj/effect/turf_decal/tile/neutral{dir = 8},/obj/effect/turf_decal/tile/neutral,/obj/effect/turf_decal/tile/neutral{dir = 1},/obj/effect/turf_decal/tile/neutral{dir = 4},/obj/structure/railing,/obj/effect/turf_decal/siding/thinplating/dark,/obj/effect/oneway,/turf/open/floor/iron/dark,/area/tdome/arena{name = "Talent Show Theatre"})
"g" = (/obj/structure/alien/weeds,/obj/item/food/deadmouse,/turf/open/floor/mineral/titanium/tiled,/area/tdome/arena)
"j" = (/obj/structure/alien/weeds,/obj/item/food/grown/ambrosia,/turf/open/floor/mineral/titanium/tiled,/area/tdome/arena)
"k" = (/obj/effect/turf_decal/tile/neutral{dir = 8},/obj/effect/turf_decal/tile/neutral,/obj/effect/turf_decal/tile/neutral{dir = 1},/obj/effect/turf_decal/tile/neutral{dir = 4},/obj/structure/railing/corner,/obj/effect/turf_decal/siding/thinplating/dark/corner,/turf/open/floor/iron/dark,/area/tdome/arena{name = "Talent Show Theatre"})
"m" = (/obj/effect/turf_decal/siding/wood{dir = 9},/obj/effect/oneway{dir = 1},/obj/effect/oneway{dir = 8},/turf/open/floor/iron/dark/smooth_large,/area/tdome/arena{name = "Talent Show Theatre"})
"o" = (/obj/effect/turf_decal/siding/wood{dir = 5},/obj/effect/oneway{dir = 1},/obj/effect/oneway{dir = 4},/turf/open/floor/iron/dark/smooth_large,/area/tdome/arena{name = "Talent Show Theatre"})
"r" = (/obj/machinery/door/window{dir = 1},/obj/structure/alien/weeds,/turf/open/floor/mineral/titanium/tiled,/area/tdome/arena)
"u" = (/obj/structure/alien/weeds,/obj/structure/alien/weeds/node,/obj/effect/decal/cleanable/blood/xtracks,/turf/open/floor/mineral/titanium/tiled,/area/tdome/arena)
"v" = (/obj/structure/alien/weeds,/obj/structure/alien/weeds/node,/obj/item/organ/body_egg/alien_embryo,/turf/open/floor/mineral/titanium/tiled,/area/tdome/arena)
"x" = (/obj/effect/turf_decal/tile/neutral{dir = 8},/obj/effect/turf_decal/tile/neutral,/obj/effect/turf_decal/tile/neutral{dir = 1},/obj/effect/turf_decal/tile/neutral{dir = 4},/obj/structure/railing/corner{dir = 8},/obj/effect/turf_decal/siding/thinplating/dark/corner{dir = 8},/turf/open/floor/iron/dark,/area/tdome/arena{name = "Talent Show Theatre"})
"y" = (/obj/structure/alien/weeds,/obj/effect/decal/cleanable/blood/xtracks,/turf/open/floor/mineral/titanium/tiled,/area/tdome/arena)
"C" = (/obj/effect/turf_decal/siding/wood/corner{dir = 1},/obj/effect/turf_decal/siding/wood/corner{dir = 4},/obj/effect/turf_decal/tile/neutral{dir = 8},/obj/effect/turf_decal/tile/neutral,/turf/open/floor/iron/dark,/area/tdome/arena{name = "Talent Show Theatre"})
"E" = (/obj/structure/alien/weeds,/obj/structure/alien/weeds/node,/obj/effect/decal/cleanable/insectguts,/turf/open/floor/mineral/titanium/tiled,/area/tdome/arena)
"F" = (/obj/structure/alien/weeds,/obj/structure/alien/weeds/node,/obj/item/food/grown/ambrosia,/turf/open/floor/mineral/titanium/tiled,/area/tdome/arena)
"G" = (/obj/structure/alien/weeds,/obj/effect/decal/remains/xeno,/turf/open/floor/mineral/titanium/tiled,/area/tdome/arena)
"I" = (/obj/structure/alien/weeds,/obj/structure/grille/indestructable,/obj/effect/spawner/structure/window/plasma,/turf/open/floor/mineral/titanium/tiled,/area/tdome/arena)
"K" = (/obj/structure/alien/weeds,/obj/structure/alien/weeds/node,/obj/structure/alien/weeds/node,/obj/item/organ/alien/eggsac,/obj/effect/decal/cleanable/insectguts,/turf/open/floor/mineral/titanium/tiled,/area/tdome/arena)
"N" = (/obj/structure/alien/weeds,/obj/structure/alien/egg/grown,/turf/open/floor/mineral/titanium/tiled,/area/tdome/arena)
"Q" = (/obj/effect/turf_decal/tile/neutral{dir = 8},/obj/effect/turf_decal/tile/neutral,/obj/effect/turf_decal/tile/neutral{dir = 1},/obj/effect/turf_decal/tile/neutral{dir = 4},/turf/open/floor/iron/dark,/area/tdome/arena{name = "Talent Show Theatre"})
"R" = (/obj/structure/alien/weeds,/obj/structure/alien/weeds/node,/obj/item/toy/cattoy,/turf/open/floor/mineral/titanium/tiled,/area/tdome/arena)
"T" = (/obj/effect/turf_decal/tile/neutral{dir = 8},/obj/effect/turf_decal/tile/neutral,/obj/effect/turf_decal/tile/neutral{dir = 1},/obj/effect/turf_decal/tile/neutral{dir = 4},/obj/structure/railing{dir = 8},/obj/effect/turf_decal/siding/thinplating/dark{dir = 8},/obj/effect/oneway{dir = 8},/turf/open/floor/iron/dark,/area/tdome/arena{name = "Talent Show Theatre"})
"V" = (/obj/effect/turf_decal/tile/neutral{dir = 8},/obj/effect/turf_decal/tile/neutral,/obj/effect/turf_decal/tile/neutral{dir = 1},/obj/effect/turf_decal/tile/neutral{dir = 4},/obj/structure/railing{dir = 4},/obj/effect/turf_decal/siding/thinplating/dark{dir = 4},/obj/effect/oneway{dir = 4},/turf/open/floor/iron/dark,/area/tdome/arena{name = "Talent Show Theatre"})

(1,1,1) = {"
IIIIIIIrIIIIIII
IcbjgGdddNddRbI
IcddbdEdbddddFI
IIIIIeydKbIIIII
CCCCIdydbdICCCC
ffxQIvudddIQkff
aoTQIIIIIIIQVma
"}
