"a" = (/obj/effect/turf_decal/siding/wood{dir = 1},/obj/effect/oneway{dir = 1},/turf/open/floor/iron/dark/smooth_large,/area/tdome/arena{name = "Talent Show Theatre"})
"b" = (/obj/effect/turf_decal/tile/green/half{dir = 4},/obj/effect/turf_decal/tile/green{dir = 8},/obj/structure/table/glass,/obj/structure/closet/mini_fridge,/obj/item/reagent_containers/food/drinks/beer,/obj/item/reagent_containers/food/drinks/beer,/obj/item/reagent_containers/food/drinks/beer,/obj/item/reagent_containers/food/drinks/beer,/turf/open/floor/iron/white,/area/tdome/arena_source)
"d" = (/obj/effect/turf_decal/tile/neutral{dir = 8},/obj/effect/turf_decal/tile/neutral,/obj/effect/turf_decal/tile/neutral{dir = 1},/obj/effect/turf_decal/tile/neutral{dir = 4},/turf/open/floor/iron/dark,/area/tdome/arena_source)
"e" = (/obj/effect/turf_decal/tile/neutral{dir = 8},/obj/effect/turf_decal/tile/neutral,/obj/effect/turf_decal/tile/neutral{dir = 1},/obj/effect/turf_decal/tile/neutral{dir = 4},/obj/structure/railing{dir = 8},/obj/effect/turf_decal/siding/thinplating/dark{dir = 8},/obj/effect/oneway{dir = 8},/turf/open/floor/iron/dark,/area/tdome/arena{name = "Talent Show Theatre"})
"g" = (/obj/structure/bed,/obj/item/bedsheet/medical,/obj/effect/turf_decal/tile/green/half{dir = 1},/turf/open/floor/iron/white,/area/tdome/arena_source)
"i" = (/obj/effect/turf_decal/tile/neutral{dir = 8},/obj/effect/turf_decal/tile/neutral,/obj/effect/turf_decal/tile/neutral{dir = 1},/obj/effect/turf_decal/tile/neutral{dir = 4},/obj/structure/railing,/obj/effect/turf_decal/siding/thinplating/dark,/obj/effect/oneway,/turf/open/floor/iron/dark,/area/tdome/arena{name = "Talent Show Theatre"})
"j" = (/obj/effect/turf_decal/siding/wood{dir = 5},/obj/effect/oneway{dir = 1},/obj/effect/oneway{dir = 4},/turf/open/floor/iron/dark/smooth_large,/area/tdome/arena{name = "Talent Show Theatre"})
"k" = (/obj/effect/turf_decal/tile/green/half{dir = 1},/turf/open/floor/iron/white,/area/tdome/arena_source)
"m" = (/obj/effect/turf_decal/tile/green/half{dir = 8},/obj/structure/table/glass,/obj/item/toy/figure/virologist,/turf/open/floor/iron/white,/area/tdome/arena_source)
"n" = (/obj/effect/turf_decal/tile/neutral{dir = 8},/obj/effect/turf_decal/tile/neutral,/obj/effect/turf_decal/tile/neutral{dir = 1},/obj/effect/turf_decal/tile/neutral{dir = 4},/obj/structure/railing,/obj/effect/turf_decal/siding/thinplating/dark,/obj/effect/oneway,/turf/open/floor/iron/dark,/area/tdome/arena_source)
"o" = (/obj/effect/turf_decal/tile/green/half{dir = 4},/turf/open/floor/iron/white,/area/tdome/arena_source)
"p" = (/obj/structure/grille,/obj/effect/spawner/structure/window/reinforced/indestructable,/turf/open/floor/iron/white,/area/tdome/arena_source)
"q" = (/obj/effect/turf_decal/tile/green{dir = 8},/turf/open/floor/iron/white,/area/tdome/arena_source)
"r" = (/obj/effect/turf_decal/tile/neutral{dir = 8},/obj/effect/turf_decal/tile/neutral,/obj/effect/turf_decal/tile/neutral{dir = 1},/obj/effect/turf_decal/tile/neutral{dir = 4},/obj/structure/railing/corner{dir = 8},/obj/effect/turf_decal/siding/thinplating/dark/corner{dir = 8},/turf/open/floor/iron/dark,/area/tdome/arena_source)
"u" = (/obj/effect/turf_decal/tile/neutral{dir = 8},/obj/effect/turf_decal/tile/neutral,/obj/effect/turf_decal/tile/neutral{dir = 1},/obj/effect/turf_decal/tile/neutral{dir = 4},/turf/open/floor/iron/dark,/area/tdome/arena{name = "Talent Show Theatre"})
"w" = (/obj/effect/turf_decal/tile/green,/turf/open/floor/iron/white,/area/tdome/arena_source)
"x" = (/obj/structure/rack,/obj/item/reagent_containers/syringe,/obj/item/reagent_containers/syringe,/obj/item/reagent_containers/syringe,/obj/item/reagent_containers/syringe,/obj/item/reagent_containers/glass/beaker/synthflesh,/obj/item/reagent_containers/glass/beaker/synthflesh,/obj/item/reagent_containers/glass/beaker/synthflesh,/obj/effect/turf_decal/tile/green/half,/turf/open/floor/iron/white,/area/tdome/arena_source)
"y" = (/obj/effect/turf_decal/tile/green/half,/obj/effect/turf_decal/tile/green{dir = 1},/obj/machinery/computer/pandemic,/turf/open/floor/iron/white,/area/tdome/arena_source)
"z" = (/obj/effect/turf_decal/tile/green/half{dir = 1},/obj/effect/turf_decal/tile/green,/obj/structure/table/glass,/obj/machinery/microwave,/turf/open/floor/iron/white,/area/tdome/arena_source)
"A" = (/obj/structure/window/reinforced{dir = 4},/obj/effect/turf_decal/tile/green/half,/turf/open/floor/iron/white,/area/tdome/arena_source)
"B" = (/obj/structure/table/glass,/obj/item/storage/box/syringes,/obj/item/storage/box/beakers,/turf/open/floor/iron/white,/area/tdome/arena_source)
"C" = (/obj/effect/turf_decal/tile/green/half,/turf/open/floor/iron/white,/area/tdome/arena_source)
"E" = (/obj/structure/grille,/obj/effect/spawner/structure/window/reinforced/indestructable,/obj/effect/turf_decal/tile/green,/turf/open/floor/iron/white,/area/tdome/arena_source)
"F" = (/obj/effect/turf_decal/tile/neutral{dir = 8},/obj/effect/turf_decal/tile/neutral,/obj/effect/turf_decal/tile/neutral{dir = 1},/obj/effect/turf_decal/tile/neutral{dir = 4},/obj/structure/railing/corner,/obj/effect/turf_decal/siding/thinplating/dark/corner,/turf/open/floor/iron/dark,/area/tdome/arena_source)
"G" = (/obj/effect/turf_decal/tile/green/half{dir = 1},/obj/item/kirbyplants/random,/turf/open/floor/iron/white,/area/tdome/arena_source)
"H" = (/obj/structure/table/glass,/obj/item/restraints/handcuffs/cable/white,/obj/item/restraints/handcuffs/cable/white,/obj/item/restraints/handcuffs/cable/white,/obj/item/restraints/handcuffs/cable/white,/obj/item/restraints/handcuffs/cable/white,/obj/item/restraints/handcuffs/cable/white,/obj/item/restraints/handcuffs/cable/white,/obj/item/reagent_containers/dropper,/obj/effect/turf_decal/tile/green/half{dir = 8},/obj/effect/turf_decal/tile/green,/turf/open/floor/iron/white,/area/tdome/arena_source)
"I" = (/turf/open/floor/iron/white,/area/tdome/arena_source)
"K" = (/obj/effect/turf_decal/tile/green/half{dir = 4},/obj/structure/chair/office/light{dir = 8},/turf/open/floor/iron/white,/area/tdome/arena_source)
"L" = (/obj/effect/turf_decal/tile/green/half,/obj/structure/table/glass,/obj/item/storage/box/donkpockets,/turf/open/floor/iron/white,/area/tdome/arena_source)
"M" = (/obj/structure/table/glass,/turf/open/floor/iron/white,/area/tdome/arena_source)
"N" = (/obj/effect/decal/cleanable/blood/drip,/obj/effect/turf_decal/tile/green/half{dir = 1},/turf/open/floor/iron/white,/area/tdome/arena_source)
"P" = (/obj/effect/turf_decal/siding/wood/corner{dir = 1},/obj/effect/turf_decal/siding/wood/corner{dir = 4},/obj/effect/turf_decal/tile/neutral{dir = 8},/obj/effect/turf_decal/tile/neutral,/turf/open/floor/iron/dark,/area/tdome/arena{name = "Talent Show Theatre"})
"R" = (/obj/effect/turf_decal/tile/green/half{dir = 8},/obj/machinery/smartfridge/chemistry/virology/preloaded,/turf/open/floor/iron/white,/area/tdome/arena_source)
"S" = (/obj/machinery/door/window{dir = 4},/obj/effect/turf_decal/tile/green/half{dir = 1},/turf/open/floor/iron/white,/area/tdome/arena_source)
"T" = (/obj/effect/turf_decal/siding/wood/corner{dir = 1},/obj/effect/turf_decal/siding/wood/corner{dir = 4},/obj/effect/turf_decal/tile/neutral{dir = 8},/obj/effect/turf_decal/tile/neutral,/turf/open/floor/iron/dark,/area/tdome/arena_source)
"V" = (/obj/effect/turf_decal/siding/wood{dir = 9},/obj/effect/oneway{dir = 1},/obj/effect/oneway{dir = 8},/turf/open/floor/iron/dark/smooth_large,/area/tdome/arena_source)
"W" = (/obj/effect/decal/cleanable/blood,/obj/effect/turf_decal/tile/green/half,/turf/open/floor/iron/white,/area/tdome/arena_source)
"X" = (/obj/effect/turf_decal/tile/green/half{dir = 4},/obj/effect/turf_decal/tile/green{dir = 8},/obj/structure/table/glass,/obj/item/reagent_containers/dropper,/turf/open/floor/iron/white,/area/tdome/arena_source)
"Y" = (/obj/effect/turf_decal/tile/neutral{dir = 8},/obj/effect/turf_decal/tile/neutral,/obj/effect/turf_decal/tile/neutral{dir = 1},/obj/effect/turf_decal/tile/neutral{dir = 4},/obj/structure/railing{dir = 4},/obj/effect/turf_decal/siding/thinplating/dark{dir = 4},/obj/effect/oneway{dir = 4},/turf/open/floor/iron/dark,/area/tdome/arena_source)
"Z" = (/obj/machinery/door/window{dir = 1},/turf/open/floor/iron/white,/area/tdome/arena_source)

(1,1,1) = {"
pppppppZEpppppp
pgNkSkkkkkGkkzp
pHWxAqIIIwCCCbp
pppppmIIBoppppp
PTTTERIIMKpTTTT
iirdpyCCLXpdFnn
ajeupppppppdYVa
"}
